########
#GT#G?##
#G?#GT##
##LGGT##
##T#GT##
##?#GG##
########